www-w!w-www
w--@---&--w
-#-------*-
w----p----w
-$-------(-
w--%---)--w
www-w^w-www